111111111111111111
111111100111P00011
1111110K01100110C1
1111100101111110K1
111100110111110011
111001110111100111
110011110111001111
100111110110011111
1K0000000C0K111111
111111110100K000E1
111111111111111111