1111111111111
1110001K0C011
110P10K0110C1
10000K0000011
1100011000111
111K01101CK11
11C00110100E1
1111111111111