111111111
100000C011
10P0000011
10C000E01
100000001
111111111