1111111111111111
10000CCCCCCCCCC1
1E100CCCCCCCCCC1
11100CCCCCCCCCC1
10000CCCCCCCCCC1
10000CCCCCCCCCC1
10000CCCCCCCCCC1
10000CCCCCCCCCC1
10000CCCCCCCCCC1
10000CCCCCCCCCC1
10000CCCCCCCCCC1
11100CCCCCCCCCC1
1P100CCCCCCCCCC1
10000CCCCCCCCCC1
10000CCCCCCCCCC1
1111111111111111