11111111111111111111
11111110011111P00011
1111110K0111100110C1
111110010111111110K1
11110011011111110011
11100111011111100111
11001111011111001111
10011111011110011111
1K0000000K1100111111
11111111011100K000E1
11111111111111111111