111111111111111111
111111100111P00011
111111K0K1100110C1
1111100101111110K1
111100110111110011
111001110111100111
110011110111001111
100111110110011111
1K000000000K111111
1111111101K00E0001
111111111111111111