111111110111111
1110001K0001101
110P10001100100
100000000001101
110001100K11101
1110011010K11P1
1100011010001E1
1111111111111*1
0111111E1111111
11111111111111