111111111111111
111111110CK0011
11C0C110K111011
1K0K0K100000011
10K0K010P100011
100K001001100K1
111000K00110K11
11111110011K001
111000110100111
11E010000110C11
111111111111111