1111111111
110P10C111
1000001111
110C0000E1
1111111111