1111111111
1E10101011
101000C011
10K0001111
11C10000P1
1111111111