111111111
11PC00011
110CE0011
111111111