1111111111111
1110001K0C011
110P1000110C1
1000000000011
110001100K111
111001101CK11
11C00110100E1
1111111111111