1111111111111111
1PCE000000000001
1K0K0K0K0K0K0K01
100K00000000K001
1K000K0000K000K1
1111111111111111
1K01KK10K1K00001
10K1KK1K010K0001
1K01KK10K100K001
10K1KK1K01000K01
1K01KK10K10000K1
1111111111111111
