1111111111111111
1PCE000000000001
1K0K0K0K0K0K0K01
1K00000K000000K1
10K00000000000K1
1111111111K000K1
11111111110K0001
110K11111100K001
1111111111000K01
1111111111111111
