111111111111
11E001000011
10P10C0100C1
10C1C0000011
100001000111
111111111111