1111111111111
1110001000011
110P10C0110C1
10C00C0000011
1100011000111
1110011010011
11C00110100E1
1111111111111