111111111
1CCP00011
1CCCCCCE1
111111111