111111111
1P0000011
100000011
10C100011
1000000E1
111111111