11111111111
10000000101
1P10000C101
10101110101
10110000101
1CC0001E101
11111111111