1111111111111
1110001000011
110P10C0110C1
10C01C0000011
1100001000111
1110001000011
11C01000100E1
1111111111111