1111111111111111
1PCE000000000001
1000000000000001
10000000K0000001
1000000000000001
1111111000000001
1111111000000001
1100111000000001
1111111000000001
1111111111111111
