111111111
1P10000C1
100011101
111100001
1CC0001E1
111111111