1111111111111
11100010CC011
110P10C0110C1
10C00CCC00011
1100011000111
111001101C011
11C00110100E1
1111111111111