1111111111111111
1010010001000001
1010010001000001
1000000000011101
1PCE01C10C011111
1000000C000CCCC1
1010110111011111
1000000000000001
1010110111011111
1111111111111111
