111111111111111111111111111111111111111111111111111111111111111111111111
111111111111111111111111111111111111111111111111111111111111111111111111
111111111111111111111111111111111111111111111111111111111111111111111111
1111P0000C0000000000000000011111111111111100000C000000000000000001111111
111100011111011110110111110111111111111111000111110111101101111101111111
11110C0000000000000C00000101111111111111110C0000000000000C00000101111111
111100011011110111110111110111111111111111000110111101111101111101111111
11111C0000000000000000000101111111111111111C0000000000000000000101111111
111100011111111111111111110111111111111111000111111111111111111101111111
111110000100010001000100010111111111111111100001000100010001000101111111
111100C100010001000100010E011111111111111100C100010001000100010001111111
111111111111111111111111111111111111111111111111111111111111111111111111
111111111111111111111111111111111111111111111111111111111111111111111111
111111111111111111111111111111111111111111111111111111111111111111111111
111111111111111111111111111111111111111111111111111111111111111111111111
111111111111111111111111111111111111111111111111111111111111111111111111
111111111111111111111111111111111111111111111111111111111111111111111111
111111111111111111111111111111111111111111111111111111111111111111111111
111111111111111111111111111111111111111111111111111111111111111111111111
111111111111111111111111111111111111111111111111111111111111111111111111
111111111111111111111111111111111111111111111111111111111111111111111111
111111111111111111111111111111111111111111111111111111111111111111111111
111100000C0000000000000000011111111111111100000C000000000000000001111111
111100011111011110110111110111111111111111000111110111101101111101111111
11110C0000000000000C00000101111111111111110C0000000000000C00000101111111
111100011011110111110111110111111111111111000110111101111101111101111111
11111C0000000000000000000101111111111111111C0000000000000000000101111111
111100011111111111111111110111111111111111000111111111111111111101111111
111110000100010001000100010111111111111111100001000100010001000101111111
111100C1000100010001000100011111111111111100C100010001000100010001111111
111111111111111111111111111111111111111111111111111111111111111111111111
111111111111111111111111111111111111111111111111111111111111111111111111
111111111111111111111111111111111111111111111111111111111111111111111111
111111111111111111111111111111111111111111111111111111111111111111111111